25
18
37 36 38 41 40 39 38 41 38 39 41 39 41 41 40 41 41 41 41 39 41 40 38 36 37 
37 39 39 41 40 39 40 39 38 38 39 38 40 39 40 40 41 38 39 40 40 40 38 36 37 
37 36 39 41 39 39 41 40 39 41 39 41 39 39 39 39 41 41 39 41 39 39 39 36 37 
37 36 39 40 38 39 39 38 38 39 38 41 39 39 38 38 39 39 38 41 39 40 39 36 37 
37 36 40 40 39 40 40 40 41 40 39 41 40 39 41 40 39 41 40 39 41 40 41 36 37 
37 32 33 34 35 29 30 31 32 33 34 26 27 28 29 30 31 32 33 34 25 26 27 28 37 
37 0 0 0 0 0 0 0 0 0 0 0 0 0 0 0 0 0 0 0 0 0 0 0 37 
37 0 0 0 0 0 0 0 0 0 0 0 0 0 0 0 0 0 0 0 0 0 0 0 37 
37 0 0 0 0 0 0 0 0 0 0 0 0 0 0 0 0 0 0 0 0 0 0 0 37 
37 0 0 0 0 0 0 0 0 0 0 0 0 0 0 0 0 0 0 0 0 0 0 0 37 
37 0 0 0 0 0 0 0 0 0 0 0 0 0 0 0 0 0 0 0 0 0 0 0 37 
37 0 0 0 0 0 0 0 0 0 0 0 0 0 0 0 0 0 0 0 0 0 0 0 37 
37 0 0 0 0 0 0 0 0 0 0 0 0 0 0 0 0 0 0 0 0 0 0 0 37 
37 0 0 0 0 0 0 0 0 0 0 0 0 0 0 0 0 0 0 0 0 0 0 0 37 
37 37 22 22 0 0 0 0 0 0 0 0 0 0 0 0 0 0 0 0 0 22 22 37 37 
37 37 0 0 22 0 0 0 0 0 0 0 0 0 0 0 0 0 0 0 22 0 0 37 37 
37 37 0 0 0 0 0 0 0 0 0 0 0 0 0 0 0 0 0 0 0 0 0 37 37 
21 21 21 21 21 21 21 21 21 21 21 21 21 21 21 21 21 21 21 21 21 21 21 21 21 
